##########
#S......G#
#.#.####.#
#.#....#.#
#.######.#
#........#
##########